R 300 300
NO textures/santa-claus.xpm
SO textures/shutterstock_334048556_2.xpm
EA textures/house.xpm
WE textures/jrd_191210_5_1.xpm

   S ./textures/christmas_mark2_present.xpm
C       50,200,50
F   250,50,50



        1111111111111111111111111
        1000000000110000000000001
        1011000001110000002000001
        1001000000000000000000001
111111111011000001110000000000001
100000000011000001110111110111111
11110111111111011100000010001
11110111111111011101010010001
11000000110101011100000010001
10000000000222001100000010201
10000000000000001101010010001
11000001110101011111011110N0111
1111011101110101 101111010001
11111111 111111 111111111111
