11111111111111111111
1000000000002001S001
10000000000000010001
10000000000000000201
10001101010101000001
10000001000000000201
10000001000000000001
10000000000001000001
10000000000000000001
10000000000010000201
10000000010010000001
10000000000010000001
1111111111111111111
R 100 100

NO ./image/test.xpm
       SO ./image/test.xpm

WE ./image/test.xpm
EA ./image/test.xpm
S ./image/test.xpm
    F 255,255,255
C 255,255,255


